111111111111111111111
10000000000C00C000001
101010001010010010101
101010101010010010101
100P00000000000C00001
1D0C00110E0C000C00001
110011110011111100001
10D00000001000C000001
10000C000010000000C01
1C0D0C000010000000001
111111111111111111111