1111111111111111111111111111111
1000000000000000C0000CC00000001
1010100100000101001000000010101
1010010101010001001000000010101
100P00000000000000000000CC00001
100000110000D000000000000DC0001
1D0C0011000000E000000C000C00001
1100001111001000001111100000001
10D000000000100000C000000000001
10D0000C00001000000000C00000001
10000D0C00001000000000000000001
1111111111111111111111111111111